1111111111111111111111111111111111
100000000000000C111000000000000001
10P00000000000000010000000C0000001
1000000111100001111111110000000001
10000C0000000000001000001111000001
10000000000001000C0000000001000001
1000000111111100000000000001000001
1010000000000100000000000C01000001
101000000C000000000000000000000001
1001100000000000000000000000010001
1000110000000000000000000000111001
1000011000000000001110000000010001
1001111110000000001C00000000000001
1000000000000000001110000000000001
1C00000000000000000101000000000001
10000000000000111111010000000C0001
1011000000000000000001000000000001
1001000C00000000001111000000000E01
100100000000000000000000C000000001
1111111111111111111111111111111111
