11111111
1000C001
10001111
1C00E0P1
11111111
