1111111111111111111111111111111111
100C00000000000C00000C0000001E1001
1010010100100000101001000000100101
10100100101010100C1001000000010101
1P0000000C00000000000000C0000010C1
1111111111111111111111111111111111
