1111111111111111111111111111111111
1E1000000000000C00000C000000C00001
1010010100100000101001000000010101
1010010010101010001001000000010101
110000000C00C0000000P00000000000C1
1111111111111111111111111111111111
